En̄ hier volgt de dʼde boec
1 IC māne mettē wiuē :
Die dit gedichte lesē en̄ scᶦuē : Op dē hoechstē
ban : Dꝫ sijt latē reene bliuē : En̄ siʼe nᵗ in
ē dᶦuē : Woert lettere af ochte an : Doē
sijt oec hen sal becliuē : Mij̄ ban en̄ sine selen
ne af wᶦuē : Niet gemogē nochtan : Hens

25
26

.iij.
geen spot dit vā katyuē : Hets daʼ ic mi lieuʼ
ō liete ōtliuē : Eer ickʼ sciede vā : Nu hore
die leerē can : 
Iacob wi hebbē ondʼlinghe :
Ghehādelt messelike dīge : Nu ātwʼdt mi
op een : En̄ leʼt mi eer ic di ōtsprīge : Hoe
ic mij̄ hʼte daʼtoe dwīge : Te kīnēne hē dien
wi vleen : Jc lese somwile en̄ singe : Dꝫ go
de te kīnene bi sinē gehīge : Es leuē sondʼ
ween : Dit es waʼhᵗ claer en̄ gīge : Subtijl-
ware thʼte diet beuīge : Wāt hoger dīc en
es negeen : Nu ātwʼdt mi tusschē ōs tween :
Mertē du vᵘges te hoge : Al vlogic bouē
dʼ ingele vloge : Bouē cherub en̄ seraph :
So weetic wel dꝫ ickē moge : Berechtē dꝫ
te vollē doge : Mꝫ woʼdē nᵗ hier af : Alle sin-
ne sij̄ te dᵒege : Alle cᵉat²en hoemēt poege : En
dogē nᵗ een caf : Dꝫ harre enech te vollen
doge : Mʼ vʼscerp dij̄s sins oege : En̄ hore wat
mi scᵉfture gaf : Houdꝫ ī dij̄re hʼten graf :
Moyses sprect in sinē boekē : Beestē die
dē berch besoekē : moetē sij̄ gesteent : Bees
te es die mēsche die wille roekē : Te nauwe
ō die godhᵗ loekē : Hets recht dꝫ hijt beweēt
Du soecs mi ī allē hoekē : Mꝫ rimen sonder
valschᵗ vlas vā doekē : Es dit goꝫ ic wane neent :
Du tels mi mettē wisen cloekē : Waʼt goꝫ
ic soudʼ di ō vloekē : Jc wane dij̄ hʼte meent :
Dattu mi heefs vʼbeent :
Iacob dune souts


2
3
4
.5


di nᵗ vʼgᵘmē : Jc souts mi ī mij̄ hʼte scamē : Haddict
oyt gedocht : Oec lie ics mꝫ di te samē : Dꝫ die
hoechᵗ dʼ hoger namē : Te verre nᵗ ē doech gesocht :
Al waʼt dꝫ alle dīge qᵘmē : Sine cōstē die godheit
nᵗ geramē : Dits elkē af gecnocht : Mʼ leere mi-
nē cᵘnckē sin minē lamen : Ghewōt mettʼ sondē
bramē : Vā dattu vʼmocht : So es mij̄ wille volbᵒcht :
Mertē nu mʼc ī dinē sinne : God es een wesē vor
alle begīne : Dedelste bouē al : Sij̄ wesē es also ic
kīne : Douʼste goꝫ douʼste mᵉ : Dꝫ es ocht wesē sal :
Sine gewʼke daer mēne kīt īne : Sij̄ so gᵒet dat
si sijn
dīne : Diet kīnē en̄ smal : Sine wijshᵗ es conī-
gīne : Bouē alrehāde gewīne : En̄ bouē alle
geval : Daʼ bouē ochte hier īt dal :
Dē hemel
en̄ dē tᵒen mʼke : God es bouē alle sine gewerke :
En̄ ondʼ alle sine dīc : Hi es butē alle dīc nu hʼ
ke : En̄ bīnē alle dīc dit houde wel stʼke : Hier
wt nᵗ ē spᶦnc : Oec seggen ōs die wise clerke :
Hi ē es nᵗ gedeilt ī ꝑke : Hier ī dij̄ hʼte dwinc :
Mʼ geheel ī elkē wʼke : Butē bīnē ī watʼ ī swʼ
ke : Hier ī dij̄ hʼte brinc : Sōdʼ enegē loesen
wīc :
Bouen al es god alse hʼe : Die besittʼe es
ēmʼmeʼre : Alles dies mē weet : Ondʼ al alse die
ī allē keere : Die dic̅ houdt mogēdelec en̄ sere :
Jegē alle vʼscheet : Butē al alse die mꝫ siʼe were :
Sij̄ wʼc behuedt dꝫ hē ē dere : Ne geen dīc cout
noch heet : Bīnē al als die mꝫ siʼe lere : Sij̄ wʼc
uʼwlt mꝫ selker ere : Dꝫ ewelike steet : Wient
lief si ochte leet :


6
7
8


.iij.
Bouē al es god ōgedᵘgē : Negeen dīc ē mach hē
beclagē : Dꝫ hise iet vʼlast : Ondʼ al sondʼ last van
wagē : Wāt hē ē moyt rustē no iagē : Sij̄ wesē
es so vast : Butē al en̄ ē breidt niewerīc sij̄ da
gē : Wāt hi es al sondʼ vᵘgē : Weert voecht en̄
nᵗ gast : Bīnē al . en̄ uʼwllt iegē plagē : Dꝫ sine
dīc mꝫ geenē vlagē : En si ongerast : Noch ge-
quetst enē bast :
Uā enē god spᵉke wi vā enen :
Diē wi vadʼ en̄ sone meenē : En̄ dē heilegē geest :
En̄ wet wel dꝫ wiere negeenē : So gᵒt ē noemē
no so cleenē : Dattʼ iemē es meest : Enē god
seggē wi enē reenē : Noch uʼvoecht no vʼbee-
nē : En̄ es‸
ser
ane uʼvreescht : Die sinē sin so laꝫ
vʼsteenē : Dꝫ hi des loechent hi moꝫ weenē :
En̄ eweleke sij̄ gevreest : Jn dē helschē tēpeest :
Wi settē dē vadʼ vorē : Ongewōnē en̄ ōge
borē : En̄ vore alle begī : Daʼ na dē sone wt
vʼcorē : Vā hē gewōnē also wijt horē : Eer
noyt begī gīc ī : Dē heilegē geest leeren
wi dē dorē : Wt desen .ij. comende ōtdoe dij̄
orē : Elc mēsche en̄ sinē sin : En latet tge
loeue nᵗ te stoerē : Wāt al hads die wʼelt geswo-
rē : Sine cōstē ō geen gewī : Ghegronden
meʼ no mī :
Eer ochte achtʼ tijt ofte stōde :
Dꝫ vʼstaꝫ wt minē monde : En was noyt ā de
se drie : Dē vadʼ sette wi als tē grōde : Daer
alle doget vte begōde : Diemē vʼstaꝫ of sie : Dē
sone als wijshᵗ diet al conde : Des vadʼs waʼhᵗ en̄
sine orconde


9
10
11
12


Die vā hē ē sciet nie : Die vādē heilegē geest
ōtbōde : Harre beidʼ mᵉ hi daʼ in vōde : Dese
drie warē oyt en̄ ye : Een god des geloeft
mie :
Niemē ē es wilt hi iet makē : Hine
moꝫ ī hē seluē smakē : Eenrāde triniteit :
Want hi moꝫ mogē dʼ dīc genakē : En̄ hi
moꝫ con̄ē ter dīc geraken : Ochte hꝫ es
hē al ōtseit : Oec moꝫ hi bi wilē daʼom wa
kē : Macht . const . wille . dese drie sakē : Vint
mē in die mēschelechᵗ : Die dese note wel
cā crakē : Hine derf beidē no hakē : Hine
vīt ī ene godhᵗ : Drie ꝑsone gereit :
Dese
god daer wi af leeren : Doet thᵒen stʼrē en̄
sōne kerē : En̄ al dꝫ ruerēde si : Nochtā sij̄
rustē es so vol eren : Dꝫ hē nᵗ en cā gederē :
Gheen porrē vʼre ochte bi : Hi es dꝫ hi was
dans geen scerē : Hine mach mēderē noch
meerē : Hi es sij̄s selues vri : Hi doꝫ hare
alle dīc generē : Sine rijchᵗ ē can niemen
vʼterē : Alle stedē vʼuult hi : Dus leeret tge-
loeue mi :
Gode ē beslut geene stede : Maʼ
alle stede beslut hi mede : Jn sij̄re godlecheit :
Die iare keert sij̄ mogēthede : En̄ nᵗ ē es
dꝫ hē kerē dede : Sine macht es so breit :
Cracht noꝫ noch geen ōvrede : En mach
hē doen ōledechede : Hoe dꝫ die sake geit :
Soe gestade es god in dē sede : Datten cᵘcht
noch gene bede : Wt sinē poere en leit :


13
14
15


.iij.
Dit es al waʼ geseit :
Hedē gistʼen es onse
leuē : En̄ daer es endde ane gedreuen :
Hꝫ si cort ochte lanc : Maer als mē van
gode vēt bescreuē : Dit woʼt hedē esser
aue bleuē : Een ewelec ōme ganc : Daer
geen endde ane ē mach cleuē : Noch geen be
gī wʼter vʼheuē : Sij̄ wesen es so stranc : Siʼe
iegewʼdechᵗ es beneuē : Dꝫ es en̄ was dus
eest bescᵉuē : En̄ nv es gemanc : Jn dese wʼelt
stranc :
Mertē nv ē clach no ē cᵒene : Dit
es een god ī drie ꝑsoene : Daer ic af spreke
die : Es euē geweldech en̄ euē scone : Euē
gelijc ī wʼelt ī tᵒene : Sij̄ dese enege drie :
Redene dᵘecht hier mꝫ die cᵒene : Mʼ tgeloeue
sonder hone : Dat ē twiuelde nie : Wat erē
hadde wijs ofte wat loene : Dꝫ wi die nᵗ ē do-
gē ene boene : Gheloefdē dꝫ elc sie : Nu āt
wʼdt mi en̄ gie :
Iacob ic lie tē begīne : Dꝫ
ic subtijlder dīc vā sīne : Niet ē hebbe gehort :
Dā du mi maecs hier ī inne : Oec proeuic
wel en̄ bekīne : Te gᵒndene dese woert : Daʼ
es ōse redene toe wel dīne : Ons ē tᵉcke geloe
ue en̄ mīne : Op wʼt tʼ hemelschʼ poert : Daʼ
god es loen bouē gewinne : En̄ daʼ tgeloeue
es conīgīne : Nu ātwʼt mi bat voert : Op dꝫ
ics nᵗ ē hebbe vʼboʼt :
Ane dē vadʼ vā hemel
rike : En̄ ane dē sone dies gelike : En̄ aen den
heilegē geest : Es mij̄ geloeue also rike : Dat


16
17
18
19


een god es diē ic wike : Hoe dꝫ ic wʼde gevreest :
Mʼ segt mi so claʼ dꝫ hꝫ blike : Hoe die sone die ee-
welike : Dē vader es alre meest : Mēschᵗ ōt
fīc vā onsē slike : Dꝫ di de gene nᵗ ē beswike :
En̄ hi di doe volleest : Die mīst wʼt en̄ was meest :
Mertē die val vā lucifere : Der houʼdē en̄ des
nijts hʼe : Die was also gᵒt : Dꝫ vele ingele ont
gouden sere : Die mꝫ hē warē vtē kere : En̄
vielē ī die doot : Doe dede god dē mēsche die ere :
Dꝫ hine sciep op dꝫ hi lere : Te doene dꝫ god ge
boet : En̄ besitte dan ēmʼmeʼre : Dʼ ingele stoel
en̄ vort mere : Nutte themelsche broꝫ : Sōdʼ
weder stoet :
En̄ ō dꝫ ic dꝫ moete gebiē : Soe
biddic dʼ maget mariē : Diene maget ōtfinc :
En̄ maget bleef dies wi alle liē : Daer wise
ōme benediē : Dꝫ si gestercke ōse dīc : En̄ moe
te clarē en̄ wiē : Dinē sin en̄ vā sōdē vrien :
Dꝫ thʼte si sōdʼ wīc : Vā alre dorꝑnie : En̄ dune
moets mi oec nᵗ tien : Dꝫ ic di te na gīc : Mʼ mi-
nē wille volbᶦnc :
Dit heeft die duuel vʼnomē :
En̄ es totʼ mēschᵗ comē : Spᵉkēde ī tserpēt : En̄
heeft tōser ōvᵒmē : Onse vordʼs doē vʼdoemē : En̄
swarlike gescent : Dit was sij̄ sōdʼlīge beroe
mē : Dꝫ hi algadʼ nᵗ hen soemē : Dꝫ volc heeft
vʼblent : Dꝰ wilde hi vtē hemele droemē : O̅ dat
ons die hemelsche bloemē : Niet ē soudē wʼdē be
kent : Daʼ hi af was ōtwent :
Die gods so-
ne sach dē mā vʼradē : En̄ dē viāt vol ouʼdaden :


21 b
20 a
22
23


.iij.
Jn roeme so gᵒet : En̄ wilde hē staē ī stadē : So dꝫ hi
bi siʼe genadē : Mariē dꝫ ōtboꝫ : Die saē mꝫ hē wʼt
geladē : Sōdʼ last of poēt vā scadē : En̄ sonder e-
nege noꝫ : Moeste sine soegē en̄ badē : Die alle
dīc mach vʼsadē : En̄ houdē ī harē scoꝫ : Dats haʼ
nᵗ ē vʼdᵒet :
Algheheel en̄ altemale : Ruste ī dʼ
maechdē sale : Gods sone en̄ gods kīt : Alghe
heel oec also wale : Was hi ī des vadʼs sale : Mꝫ
hē een ī twiuels twīt : Die mēschᵗ dans geene
hale : En besloꝫ nᵗ ī desen dale : Die godhᵗ diet
al bīt : Die godhᵗ ē heeft negene pale : Maʼ
mēschᵗ ōtfīc hier tale : God diet al mint :
Jn hem dꝰ eest bekīt :
Euē geweldech en̄
hʼe : Was hi en̄ blijft ēmʼmere : Die vader
ī dʼ godhᵗ : Mʼ eest dꝫ mē tʼ mēschᵗ kere : Soe
was hi mīder vele sere : Na die mēschelechᵗ :
Na die godhᵗ spᵉct mij̄ lere : So was ōsterflec
sij̄ ere : Dit was een bescheit : Die mēscheit
doechde vele mere : Gheesele nagele en̄ dꝫ sꝑe :
Die doot en̄ ādʼ leit : Tcruce en̄ der iodē pleit :
Die mēschᵗ liet hare besnidē : Doepē ꝓeuē ī diē
tidē : Vā dē oudē viāt : Si liet hare vaen en̄ benidē :
Dor borē hāde voete en̄ sidē : Si starf dꝰ eest becāt :
Die siele wilde tʼ hellē tidē : Daʼ si die gene wilde
vʼblidē : Die de duuel bāt : Ay hoe si gode benedidē :
Die heilegē diene sagē stridē : Jegē des duuels bᵘnt :
Daer hise vte gepᵘnt :
De godhᵗ wecte vā doode
te liue : Tvleesch dꝫ hi vādē reinē wiue : Vᵒuwē


24
25
26
27


mariē nā : Hi tᵒeste sine lieue catiue : Hier
.ij. hiʼ .iij. hiʼ .iiij. hiʼ viue : Mꝫ hen hi eten qᵘm :
Dus es die gods sone also ic scᶦue : God en̄
mensche elc mā bliue : Hier ī gehorsam :
Es oec enech man so stiue : Die iegen dit ge
loeue kiue : Hē sal themelsche lam : Ten
iōxstē wʼdē gram :
Indē hemel es hi geva
ren : Daert de sine āsagen te waren : Te
des vadʼ rechter hāt : Daer hi altoes sondʼ
sparē : Dē vadʼ bidt vor sine carē : Die hē
hier sij̄ becāt : Noch cōt hi hier hē oppēbarē :
De wʼelt doemē mꝫ sinen scaren : En̄ dē hel
schē viāt : Sōne en̄ mane sal hi vʼclarē : Die
bi adame vʼdōkʼt warē : Locht watʼ en̄ lant :
Sal purgerē een brant :
Al waest dꝫ hi
dꝰ op rande : Hi liet dē sinē hier te pande :
Sij̄ vleesch en̄ sij̄ heilech bloꝫ : Te cōsacᵉer
ne ī pᶦesters hande : Wie es die selke gaue
becande : Ochte betʼe ochte also goꝫ : Ay god
nu bᵉc ōse bande : En̄ vʼgef ōs dine ande :
En̄ dinē euelē moꝫ : Dꝫ ōse mōt en̄ ōse tāde :
Smakē moetē sondʼ scande : Dij̄ vleesch dij̄
heilech bloꝫ : Dꝫ wt dij̄re sidē woꝫ :
Vt
desē sone wt desē wōden : Wies godhᵗ niem̄
ē cā gegrōdē : Noch wies mēschelechᵗ : Soe
vloyen en̄ begōdē : De sacᵘmēte te diē stōdē :
En̄ alle salechᵗ : Nu hebbic v tgeloeue ōtbō
dē : So ic naest hebbe ōdʼvōdē : Na miere mo


28
29
.30


.iij.
gēthᵗ : Die dit geloeue vaste orcōdē : Aflaꝫ
gᵒt vā harē sōdē : Es hen altoes gereit :
Op dꝫ mē daʼ ī volsteit :
.acob du be
rechts mi scone : Berecht mi nv vā den
ꝑsone : Die mē heet heilech geest : Hoe
mij̄ geloeue sōder hoene : Te hē clem̄e en̄
winne die cᵒne : Die alre gauē es meest :
Wāt vādē vadʼ en̄ vādē sone : Hebbic bi di dꝫ v
god loene : Scone berecht vʼvreescht : Dies
dancke di die martilie vᵒne : Daʼ bouē ī dē ho
gē tᵒne : En̄ geue di volleest : Dattuere moets
comē ōgevreest :
Mertē ōs leʼt die scᵉft²e :
Dꝫ een god en̄ ene nat²e : E̅mer sij̄ dese drie:
Altoes euē na gebuere : En̄ vʼsceedē te negeēre
vre : Noch ē vʼsciedē nie : Vadʼ kīt vʼstāt tʼ cu
re : Vte desē dobbelē gods duere : Wie caent gegᵒn
dē wie : Cōt die geest die suete guere : Die
reine godhᵗ en̄ die puere : Hier op ꝓef en̄ sie
Mꝫ hʼtē en̄ dies gie :
Dits die tᵒest die alre
meeste : Hen die arm sij̄ vā geeste : Leʼt hi bli-
de sij̄ : Hi es ī pinē altoes feeste : Hi doꝫ mene-
gē die was beeste : Suuʼ wesē en̄ fij̄ : Wapē
god die dꝫ vʼheeste : Dꝫ hi vā sinē volleeste : Ge-
smaecte een dropelkij̄ : Die ware gode dalre
neeste : Negeene vᵉse vā tēpeeste : Noch negeen
venij̄ : En scaedde dʼ sielē sij̄ :
Dits svader
en̄ tsoens gaue : Rijchᵗ bouē alle haue : Fon
teine des leuēs al : Wie dꝫ geport wʼt hiʼ aue :


31
32
33
34


Wat rijcheidē mē hē gaue : Soudē hē dūkē
smal : Rijchᵗ die conīc heeft of gᵘue : En es
tiēdēdeel nᵗ vā enē caue : Gheprijst iegen
dit geval : Jhesꝰ die ruste ī dē graue :
Met deser
edelhᵗ so laue : O̅s als mē rumē sal :
Dit arme erdsche dal :
Dits svadʼs ende
tsoens mᵉ : Dits karitate daʼ altoes īne
: Rustet
die triniteit : Dits die dʼ ꝓphetē sīne : Leerde
en̄ maecte ī inne : Des gods soens mēschelechᵗ :
En es conīc noch conīgīne : Die ēmʼmeʼ aflaꝫ
gewīne : Vā siere ōsalechᵗ : Hine hebbe enen
traen al waʼ hi dīne : Van desē dauwe tsīnen
begīne : Al welvarē es ōtseit : Daer dese sij̄
ongereit :
Dese leʼde dē apostelē te waren :
Alle tōgē die doe warē : Jn die wʼelt breit : Dese
gaf dē martelarē : Dꝫ si cōstē sōdʼ mesbaren :
Doegē lief en̄ leit : Dese cā die sīne vʼclaren :
Die hen mꝫ sōdē uʼwarē : En̄ tcoude makē heit :
Sinē lieuē sinē carē : Deelt hi sōdʼ enech sparē :
Dꝫ godleke cleit : Dꝫ nēmʼmeʼ ē vʼgeit :
Wat
hulpt mʼten sin en̄ tale : Die begeuē mi altemale :
meer te spᵉkene vort : Elc ꝑsoen vʼstant mi wale :
Es selue god sōdʼ hale : Vā driē daʼ mē af hort :
Doch eest maʼ een die bʼch en̄ dale : Ghesciep . daʼ
bi groꝫ en̄ smale : Tellē hier af en̄ alle wort :
Neganc nᵗ ouʼ dese pale : Houdt dit ī dij̄re hʼtē
sale : Sone wʼtstu nᵗ vʼsmort : Jn die helsche poʼt :
Ware oec iemē die wedʼspᵘke : Dit geloeue en̄ de-


35
36
37
38


.iij. .iiij.
se sake : Hi ware ewelike vʼdoemt : Recht waʼt
dꝫ mēne ī dē bᵘnt stake : En̄ ī thelsche vier daʼ na
rake : Daʼ mē dē duuel ī droemt : Help god dꝫ ic
daʼ gerake : Daʼ ic sie en̄ daʼ ic smake : Die godhᵗ
ōgenoemt : Sone tᵉct mi die helsche drake : Niet
ter eweliker wrake : Daʼ niemē wt ē coemt :
Wiē dꝫ scaedt ochte vroemt :
Amē iacob
lieue geselle : Mi dūct dꝫ ic v sere quelle : Doch
al des haddic noꝫ : Alsic dit lese en̄ spelle : Magic
leerē alsict vʼtelle : Mij̄ geloeue al bloꝫ : Daʼ ic bi
scuwē mach die helle : Op dꝫ ic mi daer toe vʼsnelle
Te doene dꝫ god geboꝫ : Die de doot wrac vā abelle :
Moꝫ ōs bringē tʼ hoeghʼ celle : Dats ī abrahās
scoꝫ : Na dese corte doot : Amē :- Hier es de
derde boec vte Die .xxxix. clauselen ī heeft en̄
elc clausele .xiij. vʼse